46 40
24 24 24 24 24 24 24 24 24 24 24 24 24 24 24 24 24 24 24 24 24 24 24 24 24 24 24 24 24 24 24 24 31 31 31 31 31 31 31 31 31 31 31 31 31 31
25 33 33 25 25 33 33 25 25 33 33 33 34 34 34 25 25 34 34 25 25 34 34 25 25 34 34 34 34 34 24 26 31 32 40 40 40 31 31 31 40 40 40 31 31 31
26 33 33 33 33 33 33 25 25 33 33 33 34 34 34 25 25 34 34 34 34 34 34 25 25 34 34 34 34 24 25 31 32 40 40 40 40 40 31 40 40 40 40 40 31 31
25 33 33 33 33 33 26 26 26 26 35 35 35 35 26 26 26 26 34 34 34 34 26 26 26 26 34 34 24 26 31 32 40 40 40 40 40 40 40 40 40 40 40 40 40 31
26 33 33 33 33 33 33 33 33 33 33 33 33 34 34 34 34 34 34 34 34 34 34 34 34 34 34 24 25 31 32 40 40 40 40 40 40 40 40 40 40 40 40 40 31 31
25 33 33 33 33 33 33 33 33 33 33 33 33 33 34 34 34 34 34 34 34 34 34 34 34 34 24 26 31 32 40 40 2 2 40 40 40 40 40 40 40 40 40 30 31 31
26 34 33 33 33 33 33 33 33 33 33 33 33 33 34 34 34 34 34 34 34 34 34 34 34 24 25 31 32 40 40 2 2 40 40 40 40 40 40 40 40 40 40 31 31 31
25 34 33 33 33 33 33 33 33 33 33 33 33 34 34 34 34 34 34 34 34 34 34 34 24 26 31 32 40 40 40 40 40 40 40 40 40 40 40 40 40 2 40 40 31 31
26 33 33 33 33 33 33 33 33 33 33 33 33 33 33 34 34 34 34 34 34 34 34 24 25 31 32 40 40 40 40 40 40 40 40 40 40 40 40 40 2 2 2 40 40 31
25 33 33 33 33 33 24 33 33 33 33 33 33 33 33 34 34 34 34 34 34 34 24 25 32 32 32 31 40 40 40 40 40 40 40 40 40 40 40 40 40 40 2 40 40 31
26 33 33 34 24 35 26 14 24 34 34 34 34 34 33 33 33 34 34 34 34 24 25 26 0 0 0 32 31 31 40 40 40 40 40 40 40 40 40 40 40 40 40 40 31 31
25 33 35 35 25 14 14 35 25 34 34 34 34 33 33 33 33 33 34 34 24 25 26 0 0 0 0 0 32 31 31 40 40 40 40 40 40 40 40 37 40 40 40 31 31 31
26 33 35 34 26 35 14 14 26 34 34 34 34 33 33 33 33 33 33 24 25 26 0 38 18 17 19 0 10 32 31 31 40 40 40 37 40 40 40 40 37 40 40 40 31 31
25 33 33 27 0 0 0 0 0 27 33 33 33 33 33 33 33 33 24 26 14 0 0 18 16 16 16 19 0 0 32 31 40 40 40 40 40 40 40 40 40 40 40 40 40 31
26 33 27 28 42 42 14 42 41 29 29 27 33 33 33 33 33 24 26 26 0 0 18 16 16 20 16 16 19 0 0 31 31 40 40 40 40 40 40 40 40 40 40 40 40 31
26 27 28 28 42 42 42 42 42 42 42 29 28 27 33 33 24 25 26 13 0 18 16 20 16 16 16 20 16 19 0 32 31 31 40 40 38 40 40 39 39 40 40 40 31 31
27 28 28 29 42 42 42 42 42 42 42 42 29 29 28 27 26 26 0 0 0 38 16 16 16 16 16 16 16 0 0 0 32 31 31 30 40 40 40 39 40 40 40 31 31 31
28 28 29 42 42 42 42 42 42 42 42 42 42 42 28 28 28 0 13 0 38 0 20 16 16 16 16 16 20 0 0 14 0 31 31 32 40 40 40 39 37 40 40 40 31 31
28 29 42 42 42 42 42 42 42 42 42 42 42 42 29 28 28 28 28 14 0 0 16 16 16 22 16 16 16 0 0 0 31 31 32 40 40 39 40 40 40 40 40 40 40 31
28 42 42 42 42 42 42 42 42 42 42 42 42 42 42 42 29 29 29 28 0 38 2 2 2 14 2 2 2 0 9 31 31 32 40 40 40 40 40 39 40 40 40 38 40 31
28 42 42 42 42 42 42 42 42 42 42 42 42 42 42 42 42 42 42 28 38 2 2 2 14 14 14 2 2 2 31 31 32 40 40 40 40 39 40 40 40 40 40 30 31 31
28 41 41 42 42 42 42 42 42 42 42 42 42 42 42 42 42 42 42 28 28 2 2 27 14 14 14 30 2 2 31 32 40 40 40 38 39 39 40 40 40 40 40 31 31 31
28 28 41 42 42 42 42 42 42 42 42 42 42 42 42 42 42 42 42 28 28 2 27 29 14 14 14 32 31 2 31 40 40 40 37 39 39 40 40 2 2 40 40 40 31 31
28 28 28 42 42 42 42 42 42 42 42 42 42 42 42 42 42 42 42 28 28 28 29 14 14 14 14 14 32 31 31 40 40 40 38 40 40 40 40 2 40 40 40 40 40 31
28 29 41 41 42 42 42 42 42 42 42 42 42 42 42 42 42 42 42 29 29 29 14 14 14 14 14 14 14 31 32 40 40 40 40 40 40 40 40 40 37 40 40 40 40 31
28 41 41 42 42 42 42 42 42 42 42 42 42 42 42 42 42 42 42 42 42 0 14 14 14 14 14 14 14 14 39 39 40 40 40 40 40 40 40 40 40 40 40 40 31 31
28 41 41 42 42 42 42 42 42 42 42 42 42 42 42 42 42 42 42 42 42 0 14 14 14 14 14 14 14 14 39 39 40 40 40 40 40 40 40 40 40 40 40 31 31 31
28 28 41 42 42 42 42 42 42 42 42 42 42 42 42 42 42 42 42 41 41 0 14 14 14 14 14 14 14 14 39 39 40 40 40 37 40 40 40 40 40 40 40 40 31 31
28 29 41 42 42 42 42 42 42 42 42 42 42 42 42 42 42 42 42 27 27 29 14 14 14 14 14 14 14 31 31 40 40 40 40 40 40 40 40 40 40 40 2 40 40 31
28 41 41 42 42 42 42 42 42 42 42 42 42 42 42 42 42 42 27 28 28 28 29 14 14 14 14 14 31 32 32 40 40 40 40 40 40 40 40 40 2 2 2 40 40 31
28 41 41 42 42 42 42 42 42 42 42 42 42 42 42 42 42 42 28 28 28 28 28 29 14 14 14 31 31 2 40 40 40 40 40 40 40 40 40 40 2 2 40 40 31 31
28 28 42 42 42 42 42 42 42 42 42 42 42 42 42 42 42 27 28 28 14 14 28 28 14 14 14 31 31 2 2 40 40 40 37 40 40 40 40 40 40 40 40 31 31 31
28 28 28 42 42 42 42 42 42 42 42 42 42 42 42 42 42 28 28 14 14 14 14 28 14 14 14 14 31 31 40 40 40 40 40 40 40 40 37 40 40 40 40 40 31 31
28 29 41 42 42 42 42 42 42 42 42 42 42 42 42 42 27 28 28 14 14 14 14 14 14 14 14 14 31 31 40 40 40 40 40 38 40 40 40 40 40 40 40 40 40 31
28 41 41 42 42 42 42 42 42 42 42 42 42 42 42 27 28 28 14 14 14 14 1 14 14 14 14 31 31 32 40 40 40 40 40 40 40 40 40 40 37 40 40 40 40 31
28 41 42 42 42 42 42 42 42 42 42 42 42 42 42 28 28 28 14 14 14 14 14 14 14 14 14 31 32 40 40 2 2 40 40 40 40 40 40 40 40 40 40 40 31 31
28 42 42 42 42 42 42 42 42 42 42 42 42 42 27 28 28 14 14 14 14 14 14 14 14 14 31 31 40 40 40 40 2 2 40 40 40 40 40 40 40 40 40 31 31 31
28 28 42 42 42 27 42 42 42 27 42 42 42 27 28 28 14 14 14 14 14 14 14 14 14 31 31 32 40 40 37 40 31 40 40 40 40 31 40 40 40 40 31 31 31 31
28 28 28 43 28 28 28 43 28 28 28 43 27 28 28 28 14 14 14 14 14 14 14 14 31 31 31 38 40 40 40 31 31 31 40 40 31 31 31 40 40 31 31 31 31 31
29 29 29 29 29 29 29 29 29 29 29 29 29 28 28 31 31 31 31 31 31 31 31 32 32 31 31 32 32 32 32 32 32 32 32 32 32 32 32 32 32 32 32 32 32 31