46 40
0 0 0 0 0 0 0 0 0 0 0 0 0 0 0 0 0 0 0 0 0 0 0 0 0 0 0 0 0 0 0 0 31 31 31 31 31 31 31 31 31 31 31 31 31 31
0 0 0 0 0 0 0 0 0 0 0 0 0 0 0 0 0 0 0 0 0 0 0 0 0 0 0 0 0 0 0 31 31 32 40 40 40 31 31 31 40 40 40 31 31 31
0 0 0 0 0 0 0 0 0 0 0 0 0 0 0 0 0 0 0 0 0 0 0 0 0 0 0 0 0 0 31 31 32 40 40 40 40 40 31 40 40 40 40 40 31 31
0 0 0 0 0 0 0 0 0 0 0 0 0 0 0 0 0 0 0 0 0 0 0 0 0 0 0 0 0 31 31 32 40 40 40 40 40 40 40 40 40 40 40 40 40 31
0 0 0 0 0 0 0 0 0 0 0 0 0 0 0 0 0 0 0 0 0 0 0 0 0 0 0 0 31 31 32 40 40 40 40 40 40 40 40 40 40 40 40 40 31 31
0 0 0 0 0 0 0 0 0 0 0 0 0 0 0 0 0 0 0 0 0 0 0 0 0 0 0 31 31 32 40 40 2 2 40 40 40 40 40 40 40 40 40 30 31 31
0 0 0 0 0 0 0 0 0 0 0 0 0 0 0 0 0 0 0 0 0 0 0 0 0 0 31 31 32 40 40 2 2 40 40 40 40 40 40 40 40 40 40 31 31 31
0 0 0 0 0 0 0 0 0 0 0 0 0 0 0 0 0 0 0 0 0 0 0 0 0 31 31 32 40 40 40 40 40 40 40 40 40 40 40 40 40 2 40 40 31 31
0 0 0 0 0 0 0 0 0 0 0 0 0 0 0 0 0 0 0 0 0 0 0 0 31 31 32 40 40 40 40 40 40 40 40 40 40 40 40 40 2 2 2 40 40 31
0 0 0 0 0 0 0 0 0 0 0 0 0 0 0 0 0 0 0 0 0 0 26 26 32 32 32 31 40 40 40 40 40 40 40 40 40 40 40 40 40 40 2 40 40 31
0 0 0 28 14 14 14 14 14 14 14 14 28 0 0 0 0 0 0 0 0 26 26 26 38 38 0 31 31 31 40 40 40 40 40 40 40 40 40 40 40 40 40 40 31 31
0 0 0 28 14 14 14 14 14 14 14 14 28 0 0 0 0 0 0 26 26 0 0 0 38 0 0 0 31 31 31 40 40 40 40 40 40 40 40 37 40 40 40 31 31 31
0 0 0 29 14 14 14 14 14 14 14 14 28 0 0 0 0 0 26 26 0 0 0 38 18 17 19 0 0 31 31 31 40 40 40 37 40 40 40 40 37 40 40 40 31 31
0 0 0 27 29 14 14 14 14 14 14 29 27 0 0 0 0 26 26 0 0 0 0 18 16 16 16 19 0 0 31 31 40 40 40 40 40 40 40 40 40 40 40 40 40 31
0 0 27 28 28 29 14 14 14 14 29 28 28 27 0 0 0 26 0 0 0 0 18 16 16 20 16 16 19 0 0 31 31 40 40 40 40 40 40 40 40 40 40 40 40 31
0 27 28 28 28 28 14 14 14 14 28 28 28 28 27 0 26 26 0 0 0 18 16 20 16 16 16 20 16 19 0 31 31 31 40 40 38 40 40 39 39 40 40 40 31 31
27 28 28 28 42 42 42 42 42 42 42 42 42 28 28 27 26 26 0 0 0 38 16 16 16 16 16 16 16 0 0 0 31 31 31 40 40 40 40 39 40 40 40 31 31 31
28 28 28 42 42 42 42 42 42 42 42 42 42 42 28 28 28 0 0 0 38 0 20 16 16 16 16 16 20 0 0 0 0 31 31 31 40 40 40 39 37 40 40 40 31 31
28 42 42 42 42 42 42 42 42 42 42 42 42 42 28 28 28 28 28 0 0 0 16 16 16 22 16 16 16 0 0 0 31 31 31 40 40 39 40 40 40 40 40 40 40 31
42 42 42 42 42 42 42 42 42 42 42 42 42 42 42 42 28 28 28 28 0 38 2 2 2 14 2 2 2 0 0 31 31 31 40 40 40 40 40 39 40 40 40 38 40 31
42 42 42 42 42 42 42 42 42 42 42 42 42 42 42 42 42 42 42 28 38 2 2 2 14 14 14 2 2 2 31 31 31 40 40 40 40 39 40 40 40 40 40 30 31 31
42 42 42 42 42 42 42 42 42 42 42 42 42 42 42 42 42 42 42 28 28 2 2 27 14 14 14 30 2 2 31 31 40 40 40 38 39 39 40 40 40 40 40 31 31 31
42 42 42 42 42 42 42 42 42 42 42 42 42 42 42 42 42 42 42 28 28 2 27 29 14 14 14 32 31 2 31 40 40 40 37 39 39 40 40 2 2 40 40 40 31 31
42 42 42 42 42 42 42 42 42 42 42 42 42 42 42 42 42 42 42 28 28 28 29 14 14 14 14 14 32 31 31 40 40 40 38 40 40 40 40 2 40 40 40 40 40 31
42 42 42 42 42 42 42 42 42 42 42 42 42 42 42 42 42 42 42 29 29 29 14 14 14 14 14 14 14 31 31 40 40 40 40 40 40 40 40 40 37 40 40 40 40 31
42 42 42 42 42 42 42 42 42 42 42 42 42 42 42 42 42 42 42 42 42 14 14 14 14 14 14 14 14 14 39 39 40 40 40 40 40 40 40 40 40 40 40 40 31 31
42 42 42 42 42 42 42 42 42 42 42 42 42 42 42 42 42 42 42 42 42 14 14 14 14 14 14 14 14 14 39 39 40 40 40 40 40 40 40 40 40 40 40 31 31 31
42 42 42 42 42 42 42 42 42 42 42 42 42 42 42 42 42 42 42 41 41 14 14 14 14 14 14 14 14 14 39 39 40 40 40 37 40 40 40 40 40 40 40 40 31 31
42 42 42 42 42 42 42 42 42 42 42 42 42 42 42 42 42 42 42 27 27 29 14 14 14 14 14 14 14 32 32 40 40 40 40 40 40 40 40 40 40 40 2 40 40 31
42 42 42 42 42 42 42 42 42 42 42 42 42 42 42 42 42 42 27 28 28 28 29 14 14 14 14 14 32 40 40 40 40 40 40 40 40 40 40 40 2 2 2 40 40 31
42 42 42 42 42 42 42 42 42 42 42 42 42 42 42 42 42 42 28 28 0 0 0 29 14 14 14 32 40 2 40 40 40 40 40 40 40 40 40 40 2 2 40 40 31 31
42 42 42 42 42 42 42 42 42 42 42 42 42 42 42 42 42 27 28 28 0 0 0 28 14 14 14 32 40 2 2 40 40 40 37 40 40 40 40 40 40 40 40 31 31 31
42 42 42 42 42 42 42 42 42 42 42 42 42 42 42 42 42 28 28 0 0 0 0 28 14 14 14 32 40 40 40 40 40 40 40 40 40 40 37 40 40 40 40 40 31 31
42 42 42 42 42 42 42 42 42 42 42 42 42 42 42 42 27 28 28 0 0 0 0 0 0 0 0 0 40 40 40 40 40 40 40 38 40 40 40 40 40 40 40 40 40 31
42 42 42 42 42 42 42 42 42 42 42 42 42 42 42 27 28 28 0 0 0 0 0 0 0 0 0 0 40 37 40 40 40 40 40 40 40 40 40 40 37 40 40 40 40 31
42 42 42 42 42 42 42 42 42 42 42 42 42 42 42 28 28 28 0 0 0 0 0 0 0 0 0 0 40 40 40 2 2 40 40 40 40 40 40 40 40 40 40 40 31 31
42 42 42 42 42 42 42 42 42 42 42 42 42 42 27 28 28 0 0 0 0 0 0 0 0 0 0 0 40 40 40 40 2 2 40 40 40 40 40 40 40 40 40 31 31 31
42 27 42 42 42 27 42 42 42 27 42 42 42 27 28 28 0 0 0 0 0 0 0 0 0 0 0 0 40 40 37 40 31 40 40 40 40 31 40 40 40 40 31 31 31 31
28 28 28 42 28 28 28 42 28 28 28 42 27 28 28 28 0 0 0 0 0 0 0 0 0 0 0 0 40 40 40 31 31 31 40 40 31 31 31 40 40 31 31 31 31 31
29 29 29 29 29 29 29 29 29 29 29 29 29 28 28 0 0 0 0 0 0 0 0 0 0 0 0 32 32 32 32 32 32 32 32 32 32 32 32 32 32 32 32 32 32 31