17 13
30 30 30 30 30 30 30 30 30 30 30 30 30 30 30 30 30
31 31 31 31 31 31 31 31 31 31 31 31 31 31 31 31 31
32 32 32 32 32 32 32 32 32 32 32 32 32 32 32 32 32
41 41 41 41 41 41 41 41 38 38 38 38 38 38 38 38 38
41 41 41 41 41 41 41 41 41 38 38 38 38 37 38 38 38
41 41 41 41 41 41 41 41 38 39 39 38 38 38 39 39 37
41 41 41 41 41 41 41 41 38 39 38 38 38 33 38 33 33
41 41 41 41 41 41 41 41 38 38 38 38 38 38 33 38 33
41 41 41 41 41 41 41 41 41 38 38 38 35 37 38 33 33
41 41 41 41 41 41 41 41 38 38 38 38 35 33 33 33 33
41 41 41 41 41 41 41 41 37 41 38 35 38 33 38 38 33
43 43 43 43 44 44 44 44 38 38 38 37 38 37 33 33 35
0 0 0 0 0 0 0 0 0 0 0 0 0 33 33 33 33