17 13
30 30 30 30 30 30 30 30 30 30 30 30 30 30 30 30 30
31 31 31 31 31 31 31 31 31 31 31 31 31 8 8 8 31
32 32 32 32 32 32 32 32 32 32 32 32 32 8 8 8 32
0 18 17 19 0 0 0 0 0 0 0 0 0 0 7 0 0
0 16 16 16 0 0 0 0 0 0 0 0 0 0 12 0 0
14 16 21 22 14 0 0 0 0 0 0 0 0 0 0 0 0
14 14 14 14 14 0 0 0 0 0 18 17 17 17 19 0 0
0 8 8 8 0 0 0 0 0 0 16 16 16 16 16 0 0
0 8 8 8 0 9 9 9 0 0 16 16 16 21 16 0 0
0 0 7 0 0 9 9 9 0 14 16 22 16 16 16 1 0
0 0 12 0 0 0 0 0 0 14 14 14 14 14 14 14 0
0 0 0 0 0 0 0 0 0 0 0 0 0 0 0 0 0
0 0 0 0 0 0 0 0 0 0 0 0 0 0 0 0 0